#####################
#                   #
#                   #
#                   #
#      #######      #
#      #######      #
##                 ##
##                 ##
###               ###
###               ###
###               ###
###               ###
###               ###
##                 ##
##                 ##
#      #######      #
#      #######      #
#                   #
#                   #
#                   #
#####################