####################
#GGGGGGGGGGGGGGGGGG#
#GGGGGGGGGGGGGGGGGG#
#GGGGGGGGGGGGGGGGGG#
#GGGGGGGGGGGGGGGGGG#
#GGGG#GGGGGGGGGGGGG#
#GGGGGGGGGGGGGGGGGG#
#GGGGGGGGGGGGGGGGGG#
#GGGGGGGGGGGGGGGGGG#
#GGGGGGGGGGGGGGGGGG#
#GGGGGGGGGGGGGGGGGG#
#GGGGGGGGGGGGGGGGGG#
#GGGGGGGGGGGGGGGGGG#
#GGGGGGGGGGGGGGGGGG#
#GGGGGGGGGGGG#GGGGG#
#GGGGGGGGGGGGGGGGGG#
#GGGGGGGGGGGGGGGGGG#
#GGGGGGGGGGGGGGGGGG#
#GGGGGGGGGGGGGGGGGG#
####################