####################
#GGGGGGGGGGGGGGGGGG#
#GGGGGGGGGGGGGGGGGG#
#GGGGGGGGGGGGGGGGGG#
#GGGGGG######GGGGGG#
#GGGGGG######GGGGGG#
##GGGGGGGGGGGGGGGG##
 #GGGGGGGGGGGGGGGG#
 ##GGGGGGGGGGGGGG##
  #GGGGGGSGGGGGGG#
  #GGGGGGGGGGGGGG#
 ##GGGGGGGGGGGGGG##
 #GGGGGGGGGGGGGGGG#
##GGGGGGGGGGGGGGGG##
#GGGGGG######GGGGGG#
#GGGGGG######GGGGGG#
#GGGGGGGGGGGGGGGGGG#
#GGGGGGGGGGGGGGGGGG#
#GGGGGGGGGGGGGGGGGG#
####################