#####################
#                   #
#                   #
#                   #
#                   #
#                   #
##                 ##
##                 ##
###               ###
###               ###
###       S       ###
###               ###
###               ###
##                 ##
##                 ##
#                   #
#                   #
#                   #
#                   #
#                   #
#####################