#####################
#                   #
#                   #
#                   #
#                   #
#                   #
##                 ##
 #                 #
 ##               ##
  #               #
  #       S       #
  #               #
 ##               ##
 #                 #
##                 ##
#                   #
#                   #
#                   #
#                   #
#                   #
#####################