####################
#GGGGGGGGGGGGGGGGGG#
#GGGGGGGGGGGGGGGGGG#
#GGGGGGGGGGGGGGGGGG#
#GGGGGGGGGGGGGGGGGG#
#GGGGGGGGGGGGGGGGGG#
##GGGGGGGGGGGGGGGG##
 #GGGGGGGGGGGGGGGG#
 ##GGGGGGGGGGGGGG##
  #GGGGGGGGGGGGGG#
  #GGGGGGGGGGGGGG#
 ##GGGGGGGGGGGGGG##
 #GGGGGGGGGGGGGGGG#
##GGGGGGGGGGGGGGGG##
#GGGGGGGGGGGGGGGGGG#
#GGGGGGGGGGGGGGGGGG#
#GGGGGGGGGGGGGGGGGG#
#GGGGGGGGGGGGGGGGGG#
#GGGGGGGGGGGGGGGGGG#
####################